XXXXXXXXXXXXXXXXXXXXXXXXX
XP  ---  -----    UE--UKX
X UU--U--U--UUU-U U-U-UEX
X-U--- -- --- U U---U-U-X
X- ---UE U--U U UUU U---X
X- ---U  U--U-U-UE--  U X
X-U--- -- ------UE--    X
XUUU--U--U--UUUUUU--U-U X
XD ----  ----  --UU----EX
XXXXXXXXXXXXXXXXXXXXXXXXX