XXXXXXXXXXXXXXXXXXXXXXXXX     
XP ----    --  E    --- X
X U U U U U U U   U  -UUX
X----     --   -       -X
X U U U U U U U   U   U X
X --  ----    --      --X
X-U U U U U U U   U   UUX
X- ---     ----       --X
X-U U U U U U U U U---U-XXXXXX
XK- ---- ---- -   UUUUU-D    X
XXXXXXXXXXXXXXXXXXXXXXXXXXXX X
