XXXXXXXXXXXXXXXXXXXXXXXXX     
XP ---- U  --       --- X
X U U U U U U U   U  -UUX
X----   U --   -       -X
X U U UUUUU U U   U   U X
X --   ---    -       - X
X-U U UUUUU U U   U   UUX
X- ---  UEU----       --X
X-U U U UUU U U U U---U-XXXXXX
X - --K-U  -- -   UUUUU-D    X
XXXXXXXXXXXXXXXXXXXXXXXXXXXX X