XXXXXXXXXXXXXXXXXXXXXXXXX
XP ----    --  E    --- X
X U U U U U U U   U  -UUX
X----     -- E -       -X
X U U UEU U U U   U   U X
X --  ----    --      --X
X-U U U U U U U   U   UUX
X- ---E    ----       --X
X-U U U U U U U U U---U-X
XK-E---- ---- -   UUUUU-D
XXXXXXXXXXXXXXXXXXXXXXXXX