XXXXXXXXXXXXXXXXXXXXXXXXX     
XP ---- U  --       --- X
X U U U U U U U   U  -UUX
X----   U --   -       -X
X U U UUUUU U U   U   U X
X --   ---    -E      - X
X-U U UUUUU U U   U   UUX
X- ---  U  ----       --X
X-U U U U U U U U U---U-XXXXXX
X - --K-U---- -   UUUUU-D    X
XXXXXXXXXXXXXXXXXXXXXXXXXXXX X